####################
#     #     .      #
#                  #
#  $  #  @     $   #
#     #            #
#     #            #
#            +     #
#    .             #
#                . #
####################
