####################
#                  #
#           @      #
####            ####
#   $              # 
#                  #
#### $          ####
#                  #
#                  #
####################
