####################
#    .             #
#                  #
#  $     @     $   #
#                  #
#    .             #
#            #######
#    .             #
#               .  #
####################
